0100001011
0010100000
1001101100
0100000010
0001010000
1010101010
0010000010
0111010110
0011001000
1000010010
