0000001010
0110101000
0000100101
0101001000
0100101010
0010100100
1001001001
0101100100
0100000010
0001010000
