0001100001
1100011000
0011000100
0100110010
0110100100
0010001001
1000000100
0010101001
1010101010
0010000000
