00011001000100010000001000001000000010000001000000
11000100011001001010101101101111011000101010010110
00110001000101100010100100100000010111010010100000
10101010110001010110010010011110100101000111011000
10000100001100001000101001010001010000011010000010
00110001101011100011100101010110000111101000101001
01001101100000011100001100010010101000100010010100
00100100011010100001101011101000101010010100100010
01001011001001001100100000100011010011010010101010
00101001010010011001001110101110000100011010101010
10100010010100110010010001001000101110100011001010
00101010100101000110100100011011100100101000101001
10011010010100001000110010100010010101011010000100
01000011011001010110001001001010100100000100111110
00111001001010000001101010011000101010110101000100
01000100101010111100010010100011001001010010010001
01010001001001000011000100111001010010000100100110
00001101010010011000111001000110001000111010011000
01100011000100111101001010010000101011000001001010
01001000101001111000100010101101010001010100100010
10010110010100110011001110000010001101010010101100
00100010100010001011010001110100100100100100101010
01001001001001100100011010000110010010010010100010
00100100010100010101100010111000101001001001101010
10010110100001000101101010100011000010101010000100
00100010101100101000001010101101011000101000110101
10011010100011100110100110100101000101001011001100
01001010011100010010011000010100110010011010010001
01010011000001001110100011100001000100110000100100
01001000101111100000101100010111011101000110101010
00100110010001010101000001011000010001010111001000
01001010100100001010101011001011100110110010010011
00011000001010100000010000101000001010001100101000
01010011010001001101010110101010110000100101000101
00100110100101010101001010100110001110010001010000
10010000101000010010100001010001100001001110001111
01001110100111101000011101010100110100100010110000
01100000010100001101010001010110001001001001100110
00011010100111100000100110010001100100110100001010
11001001001000101010010100100100110010000011110000
00010100101010100101000010001010011001101000000110
01000010100010010000111100110001100010110101111010
01010110101100111110100001100100001100000010001010
01001000100010010000110110001111110001101011010000
01010011011001001011000010110100010110001000010101
00110110001110010010111010000010100010110111010010
10100100100000100100000100101010101010000000101000
00101001001111001010110010010010100101011110001101
01101010110001101000011001100100101000110010110000
00000010000100000011000100001110000010000100000010
