00000100010000010000
10110101000111001010
01010101101000100010
00010010001010011100
01101010110001010000
00001010001101000101
01011001100100101000
10000100010011011010
10101001001000000100
00101011101010110010
01001001000100010100
00110010010101010110
00000100100101010001
01001010010010001100
00100001001010100010
10001010011001010110
01101000100100011000
01001010010011001010
01010001001001010010
00000100100100000100
