0100010000
0010100110
0100001100
0101110001
0000000100
1011010100
0100001010
0101100000
0001011011
0100000000
