0000011000000000110000110100001010000000101100010001000000101001010000100000110001100010001010000000
0111000110101010000110000101010001010110100001000101010110100100000110010110001100001010101000111101
1000110001001001110001010101000100100100101010011001010100010001011000100011100010110000101010000100
0010001101010010011100101001111110001010100100101010110101101101010110001100011000011101001011110010
0101100001100100100001000100000101010000110010101000000100000011000001101101001010100011101100001100
0001011110001001101110010011101001001010001100101110101011111000110100010001101001001011000101010001
1100010001010010000001001000100010100101100001000010010000001010001001100110100101011000101001010100
0011010100001010110110010110011000010100010110011001100101100101100100101010101001000110100010010010
1010011010101010011000100001000111010101001000100100001000010000010010101000101010010010011010101010
0000100001001000100011011100110001010010100101001011010011010101001010001101000110101001010100100010
1011001101100101001110000010001100011010010011010000101110100010010010100101001000100101010001001100
0010010100010010010000111001010011101001001000000110100000010100100101001001010011010010001011101001
1000100011010100100101001101000110000100100101101000101101001001001000010010010100001001010011001100
0101001000010001101001100000010001101101110000110011001010010010010011100101000101010101001000010010
0010011101101011001010001111100101001001100110001000010010100110100100010001111000100001101011100100
1000101011000010010001011000010101010010001100101111001000110100101001010110001101001100100100001001
0011000000011111101101010011001000010100111001100000100010000101001011010010100100010001010010100100
1000101011100010000101010101101011010101000100011110010100101001100010001000010001110110001010010010
0110010000001000110001010100100101010011010011010011010011011010011100100101001010000100101001001100
0001010111101010001110010110010100001010001001001001001100000010100101110010101010101001000101010001
0100001000010001010001100001010110110010110101011100100001011100001101101010001001001110011001000110
0010110011010101100100010101010001100100000101001010011110100001010000001010100100100010100011010000
1001100101001000101011001001001101001001011001101001010000001111100101110010011001001000111000101010
0100001000100101001001100011100001011100100010000100001101110001001010001001100010100101000110000100
0011010010010010010100010101101110001001101100111010100100010100010000100100001100001010010010110010
0111101001001010110001000100001000100010001001000010110011000011101101010110100111010000101001001011
0111000100101010001111111001110110010100110100011010001001101010000101010001101000100111000100100000
0010010010101001100001000101000001001001100010101001100100011110110001010100010010001000011001001110
1000111000100100101100010100011100110010001001000101110011011000101010001011001001010011001010101000
0101110110110010011010100010100010100111010100101100100101000011000100100000101010101110010010101010
0000100100010111010001001001001010001010010010001010010101110100011001101010101010000000100100101010
0110101001100010010101010101010001110000111000110001010100001001000010000100100010101010010110001010
1010100011001010100100100000100100010111010011010101010011010010101101110010011111001010100010111010
0000101110010010001110010110101001000100000110010101001010001000110000001100100010010100011001000010
0110010001100101111100100010010010011001110000100100010010100110010101100001001001010001001100011010
0110100101001100001001011101010100100010001110010011100100010101110010011100010010001010100011101100
0001001000110001010010000000010010010100100010111000101010110000001010100011101001100100001000100001
0100010011000101001011101111111101001001011010010110001010101111100010001000000100110010101111001110
0011100110011011011000101000010000100011000011010001110000100000110111011111010010001001110001010000
0100010100110000000110100101000110011110011101000100010101001010001010001000101001100100100101001010
1001010010100101011100110100101011010000100000111011010010101011100001101010101010010110101100010010
0011001000101100100001000110010001000101001010100001001010100100011101001010000100100000100010100100
1000100101001001001010101000100100111101110010001010010000010001010100011001010001001110010101001010
0010010100101010010100001110001010000010001100111010110111001010010001000100100100101000100100101000
0100100101101010110001010001110001111000101001000010100000100101010110101010101110100111101010000110
0101001110001010100100110100001010001010101010011010011010110100010010110000100101101000001001110100
1001100100110010101010000011101000101100101011001001000110010010111010010111010000001011110100000010
0010001001000100100011101010001101100011001000101111110001100100010011010000010111110010000101011100
0110111010010101010100010010110101011000101111000001001100001001001001001111001100001001010001000010
0100000010101100001001001110100001000110100000110100010011110111010100010000100011101101100110111011
0101011001000011000010010000101010101100101110001001101000000000010001010110011000100100011000001000
0010100010011000101101000111101000100001000001101100000011111011001010100010100110110011000011100110
0100011010101110010100111000000101001110011100100011011010001000110000101110001000001000111100010000
0101000100100001000001100010111000100011100010011010010100100110001011001000100101100010000001011110
0000110010101010101100011101000011011000001001010010100011001101100100010011010010011101111011000010
1111111000101000101011000000011100011101111100100100001010010001010101100110001011000001000100110100
0000110010011010100000101111110001001010001001001101110001010110010000101000101001010100010010000101
0110001101000011010101000000000110101010101011100010010110000000101110101011000101100010111001011001
0101101000110100001001010110111000101000101001101010110001011010100001101010101100010100011101001010
0100001011100101101010100101000010100101000100010010101100100010001010001010000011000101001001010010
0001010000001101000010010101010110010110010111000110000010010100101100110011111111010110100110001010
1010001110101001011101000100001000110001010000111100101010110010010001000100000010001000110010110010
0011010001001010100001010011110010001101010101000001010010001010100110010101111000101010001010100100
0100010101110010001110010010001001011001010010010110010100100010010001001000000111001001101010010010
0101000100001001010001001000101100100010010100110001000011001011101100100011101000101010101100111000
0010111011100101010101100110100110101100101001001101111100010100000010010100010010010000100001010101
1010000000110001010100110001010010001010001010100100000001010101111001010101000101000110010110000100
0001011110001010000010001101001001010000101010001010111010010101000101001000111001111001001000101010
1101000011100100111001010101010100001010011001100011000100100100101001100101000010000100101111101000
0000111000010011000111010001000101100001000100001001010010010110100010001001011010110010000000001011
0111000111001000010000010110010100011110110011110101010100100010010111101010010010100100111101110010
0000101100010110100101010100100011010000001100000001010010101001010010001010101000010101000010000100
0110001001100100101011110101001001010101010001111111011010011010001000110010100111010010010110101010
1000101011010101010001000100100111000011000110000000001001010010110010010110010000110100100100100010
0011000000000100000100011101001000101000111100101111101010000100100101010101001101000101010001010100
1000110110101010111101000011010010110101000001000000010010101101001000110001010001011001001010001001
0010000001110001100011101000010110000111011110011111100100010001011010101101000101001010010100100010
0111011100100100001001011010110101010000010001010000001110100101010010000100111001011001010101010110
0010100010101011110101000001000001110101110100100110110100010010010101011001000101010011000100010000
0100010100101000000100111110011110001110000010010101000010101001010100010010011001000100010001100110
0001010101001010110010100000100000101100111101000100011010100100110010100100100011101010101010001100
1110010100010100100100101101001111100010100000111001101000010010001010101001010101010010001010110001
0001000011100010101010000010010000011010011010001001000111000101101010000010010100001001100110010100
1011111000101011100001111001010101001011010011110010010000101000100010111000110001101101110001001010
0001000101001000001101000101010100101001010100010100101010010010101001000111001110100100100101101000
0100110101010111110101101010010110100100010001010010100001110110010100011000100010010010010010001010
0010010001010000000100101000101000101011010101001001001110000101010101001010001001001001011010110100
0101001010001101010010001011000011100001100010010100010000111101010010101001100100100101000010110010
0101101001101001100101010010010100011010001110100101010101000001001000001100010110001001010110001000
0100000101001010001000010101010101001010110000001000100100101010010010110011010001110011001001101010
0011110100100100101011100100001001101100101010101010101011000100100101000111001100000100101010100100
0100001101010010011000101101010010100010001011110001101000010101001100010010100011011001000010010101
0101100001000111010110100010010100011001101000100110001110100100100001101000011000100100011000100101
0100101110011010000010011001000001000100100110001000110000101110110101000101000110110011100011010100
0010010001010010101001011100101110110101110011010011001011001110010010010101110010001000011100010010
1001000101001010011101001110010000010100101000100100100001010101010100100010001001101011000001010100
0100111001010001001000100101010111010110000010101001001010010001001001010100100111101000111101010010
0001000010010100101011001000010001010011101101000010010010110100100011010110110001000110100010001010
0110110101010011101010010011101101001100010000111011100110100010011110010000001101010010101001011010
0000000000001000001000111000000000100001000110000000001000001001000000100101100100001000100100000010
