00010000010010000000
01100101001000101101
00010000100101001000
11000001010010010010
00111010001000100100
10000100100101011001
00110010010010000010
01001001010100110110
01010100010101001000
01000011100100100101
00110100010110010000
10000101010001010110
01011001001001010010
00100010101101010110
10001010100001001000
00110100010100101010
01000001010001001001
00011110011100101100
01100000100011000110
00001010001000010000
