00101100000100010000
10100001010010100010
10010101001000101100
01000010100010101001
00001010101001000101
10101010100100110100
00100000010010000010
01001111011010110100
00110001001001000101
10100100100101010100
10010010010100001010
00101001010010100010
01000101001100010100
01010000100011011101
01001110011001100001
01110001010100101100
00000100010010001010
11011011100101110010
00100010110101000110
10001000000000010000
