0010001000
0000100010
0101100010
0010101001
1000000100
0010101001
0100100100
1001001001
0010101010
0100000000
